# This program is distributed under Gnu Lesser General Public License (cf. the
# file LICENSE in distribution).
# 
# This program is free software; you can redistribute it and/or modify
# it under the terms of the GNU Lesser General Public License as published by
# the Free Software Foundation; either version 2 of the License, or
# (at your option) any later version.
# 
# This program is distributed in the hope that it will be useful,
# but WITHOUT ANY WARRANTY; without even the implied warranty of
# MERCHANTABILITY or FITNESS FOR A PARTICULAR PURPOSE.  See the
# GNU Lesser General Public License for more details.
#
# You should have received a copy of the GNU General Public License
# along with this program; if not, write to the Free Software
# Foundation, Inc., 675 Mass Ave, Cambridge, MA 02139, USA.
0	nolla
1	yKZE
2	kaKZE
3	kolme
4	neljä
5	viiZE
6	kuuZE
7	seitsemäN
8	kahdeksaN
9	yhdeksäN
A	aa
B	bee
C	see
D	dee
E	ee
F	äfD
G	gee
H	hoo
I	ii
J	jii
K	koo
L	älD
M	ämD
N	änD
O	oo
P	pee
Q	kuu
R	ärD
S	äsD
T	tee
U	uu
V	vee
W	kaksois-_vee
X	äksD
Y	yy
Z	tsetD
aari	aari
aika	aJCÅ
alku	alCu
alue	alueE
ammus	ammuX
ampeeri	ampeeri
asianosainen	asianosaiS
# askel, väärä nom: askele
askel	askeleE
# seuraavan ESSiivissä on virhe!
asukas	asukCaB
aste	asteE
autio	autio
auto	auto
avaruus	avaruuZ
baht	baht
baudi	baudi
# alla oleva desibelistä jo
beli	beli
# seuraavassa astevaihteluvirhe, sillä 'u' lausutaan 'v':nä
becquerel	becquerel
bitti	bitTi
celsius	celsiuX
denier	denier
desibeli	desibeli
dinaari	dinaari
dirham	dirham
dollari	dollari
drakma	drakmÅ
edustaja	edustaja
eläin		eläiO
englanti	englanTi
englantilainen	englantilaiS
ennätys	ennätyX
ensimmäinen	ensimmäiS
entinen	entiS
escudo	escudo
esimerkki	esimerkCi
eteläinen	eteläiS
euro	euro
eurooppa	euroopPa
fahrenheit	fahrenheit
faradi		faradi
floriini	floriini
frangi		frangi
gallona	gallona
gooni	gooni
gramma	grammÅ
# gray: vokaalisointu mättää
gray	gray
guldeni	guldeni
hake	hakCeE
hauis	hauiX
hauki	hauCE
hehtaari	hehtaari
henki	henCE
henkilö	henkilö
hertsi	hertsi
hevosvoima	hevosvoima
huomautus	huomautuX
höyrylaiva	höyrylaiva
ihminen	ihmiS
ilmoitus	ilmoituX
intia	intiÅ
jakso	jakso
jalka	jalCÅ
jeni	jeni
# joule toimii monikossa väärin, mutta tahtoo vain yksikön...
joule	joule
johtaja	johtaja
joki	joCE
joosua	joosuÅ
julkaisija	julkaisija
julkaistu	julkaistu
jyp	jyp
# jäsen NOM "jäsen"
jäsen	jäsen
kahdeksan	kahdeksaN
kahdeksas	kahdeksaF
kahdes	kahdeF
kaksi	kaKZE
kalori	kalori
kampa	kamPÅ
kandela	kandelÅ
kappale	kappaleE
karaatti	karaatTi
katsoja	katsoja
kelvin	kelvin
kerros	kerroX
kerta	kerTa
keskus	keskuX
kilo	kilo
kolmas	kolmaF
kolme	kolme
koltta	koltTa
kopeekka	kopeekCa
kopio	kopio
koruna	korunÅ
kristus	kristuX
kruunu	kruunu
kulma	kulma
kuningas	kuninCaB
kuningatar	kuningatTaR
kunta	kunTa
kutsuttu	kutsutTu
kuu	kuu
kuudes	kuudeF
kuukausi	kuukauZE
kuusi	kuuZE
kuutio	kuutio
kymmenen	kymmeM
kymmenes	kymmeneF
kyseinen	kyseiS
kyynel	kyyneleE
laatikko	laatikCo
lapsi	lapTE
lasku	lasku
lati	lati
liira	liirÅ
lippu	lipPu
liti	liti
litra	litrÅ
lootus	lootuX
lude	luTeE
lukko	lukCo
luksi	luksi
lupa	luPa
lusikallinen	lusikalliS
luterilainen	luterilaiS
lyönti	lyönTi
lääkäri	lääkäRi
maalaiskunta	maalaiskunTa
maili	maili
mainittu	mainitTu
manner	manTeR
markka	markCÅ
mestaruus	mestaruuZ
metri	metri
mies	mieX
miljardi	miljardi
miljoona	miljoona
miljoonas	miljoonaF
milli	milli
minuutti	minuutTi
mooli	mooli
mooses	mooseX
muu	muu
nasa	nasÅ
nato	nato
neliö	neliö
neljä	neljä
neljäs	neljäF
nimi	nimE
nolla	nolla
nuori	nuorE
oikea	oikea
oppilas	oppilaB
osa	osa
osake	osakCeE
osallistuja	osallistuja
ottelu	ottelu
paikka	paikCÅ
paikkakunta	paikkakunTa
pankki	pankCi
pappi	papPi
# paras-sanalla h:stä huolehtiva poikkeussääntö...
paras	paraB
pascal	pascal
pelaaja	pelaaja
peninkulma	peninkulma
penni	penni
peseta	pesetÅ
peso	peso
paikallinen	paikalliS
piste	pisteE
pohjoinen	pohjoiS
poika	poJCa
poikanen	poikaS
poliisi	poliisi
promille	promille
prosentti	prosentTi
puheenjohtaja	puheenjohtaja
puhelin	puheliO
pullo	pullo
punta	punTa
puoli	puolE
puolue	puolueE
pykälä	pykälä
päivä	päivä
rakkaus	rakkauZ
randi	randi
ratas	ratTaB
reikä	reiCä
rial	rial
rikos	rikoX
ringit	ringit
romani	romani
rupia	rupia
rupla	rupla
röntgen	röntgen
sadas	sadaF
sanottu	sanotTu
sata	saTÅ
seitsemän	seitsemäN
seitsemäs	seitsemäF
sekunti	sekunTi
# alla oleva on hilpeä cheat...
sekuntti	sekuntTi
sentti	sentTi
sievert	sievert
sillinki	sillinCi
shillinki	shillinCI
solmu	solmu
sotilas	sotilaB
syli	sylE
syöttö	syötTö
sähkö	sähkö
taala	taalÅ
taaleri	taaleri
tapaus	tapauX
tavu	tavu
teos	teoX
tikki	tikCi
toimittaja	toimittaja
toinen	toiS
tonni	tonni
triljoona	triljoona
tuhannes	tuhanneF
tuhat	tuhaF
tunti	tunTi
tuomari	tuomaRi
tuote	tuotTeE
tuuma	tuuma
tyhjyys	tyhjyyZ
tykki	tykCi
työntekijä	työntekijä
tölkki		tölkCi
unssi	unssi
uusi	uuZE
vanhus	vanhuX
varas	varCaB
varis	variX
vasen	vaseOPa
# vieraan ESS bugaa
vieras	vieraB
viides	viideF
viikko	viikCo
viisi	viiZE
voltti	voltTi
vuosi	vuoZE
watti	watTi
won	won
yhdeksän	yhdeksäN
yhdeksäs	yhdeksäF
yhdes	yhdeF
yhdistys	yhdistyX
yksi	yKZE
yksikkö	yksikCö
yksityinen	yksityiS
yö	yö
zloty	zloty
Ä	ää
Å	oo	
Ö	öö
äes	äeX
ääni	äänE